ia=ByteArray
ga=ByteArrayCopier
l=ByteArrayPool
n=BZip2
w=BZip2State
ca=DoublyLinkable
t=Draw2D
r=FileOnDisk
c=GameCanvas
ma=GameShell
i=GZip
ea=HashTable
e=IntHashTable
h=JagException
v=JagString
aa=JavaKeyboard
qa=JavaMouse
la=JavaPixMap
j=Js5
o=Js5Index
g=Linkable
pa=Worldmap
q=WorldmapOverlay
ja=MillisTimer
m=MonotonicTime
p=Packet
f=Pix8
b=Pix24
s=PixFont
na=PixMap
sa=PreciseSleep
ka=PrivilegedRequest
u=Signlink
ta=StringInterface
fa=StringNode
ra=Timer
oa=WorldmapFont
