sign/signlink=sign/signlink
client=client
KHACHIFW=GameShell
FPVKJCAH=ViewBox
CRRWDRTI=World
DUCMKFAY=Component
NQABEVLK=ClientStream
KVCQPLIW=AnimBase
SQHJOGRT=AnimFrame
OFQAEXFV=WallDecoration
VBAXKVMG=TileOverlay
ZIKPHIFI=GroundDecoration
BMEXSMOV=ObjStack
LLORVYLP=Metadata
ZARDZRHZ=Occluder
RJXWGZGD=VertexNormal
XPBACSMK=TileUnderlay
OPNPFUJE=Loc
FEHPTPDG=Wall
NYFUGYQS=World3D
GCPOSBWX=LruCache
ARZPHHDH=HashTable
PPOHBEGB=Linkable
QTKGMFHL=Tile
PKVMXVTO=Hashable
XHHRODPC=Entity
GQOSZKJC=PathingEntity
CWNCPMLX=NpcEntity
DLZHLHNK=PlayerEntity
WBWOBAFW=LocEntity
HNKCWGJM=ObjStackEntity
SWTXAYDT=ProjectileEntity
ZKARKDQW=Model
OJEALINP=SpotAnimEntity
AFCKELYG=Draw2D
OPPOFIOL=Draw3D
CXGZMTJK=Pix24
DSMJIEPN=Pix8
YXVQXWYR=PixFont
MBMGIXGO=Packet
PHKHJKBS=OnDemandRequest
DYMVKFXP=LocSpawned
LHGXPZPG=LinkList
BISVHPUN=Stack
IVIFZQBK=PixMap
HZTFWEML=BZip2
QPNUVGRI=BZip2State
VJKFYAWG=OnDemandProvider
GHOWLKWN=OnDemand
IGSLDTHC=FileStream
JOCFVBOI=Isaac
XTGLDHGX=Jagfile
ZTQFNQRH=JString
RTHTIIVA=WordPack
OZKFTHAD=SoundEnvelope
VADHJTLJ=SoundFilter
JHDAGNBV=Wave
CLRWXPOI=SoundTone
YZDBYLRM=LocType
ZIJPRJEC=MouseTracking
CKDEJADD=NpcType
DJRMEMXO=ObjType
QDBYELAJ=Protocol
FTPNODIB=CollisionMap
MNHKFPQO=FloType
TAVAECED=IdkType
OIBEELAZ=UnkType
LKGEGIEW=SeqType
YUXCUCXD=Stats
MUDLUUBC=SpotAnimType
SXYSOXTR=VarbitType
VGXVBFVC=VarpType
RKAYAFDQ=WordFilter
CDEJWOSB=WorldRegion
