client=Client
at.ap=client,animFrameJs5
e.ay=client,animBaseJs5
dc.ag=client,configJs5
bd.ar=client,interfaceJs5
f.aq=client,synthSoundJs5
d.ac=client,mapJs5
g.at=client,midiSongJs5
g.ad=client,modelJs5
ed.bh=client,spriteJs5
r.bs=client,textureJs5
x.bk=client,binaryJs5
dt.be=client,midiJingleJs5
dt.bp=client,clientScriptJs5
v.bi=client,fontMetricJs5
e.bo=client,vorbisJs5
s.by=client,midiInstrumentJs5
v=HookReq
eb=Locale
fd=Linkable
el=Js5Remote
fz=HashTable
eq=Js5Local
ey=Js5Index
eu=StringUtil
ef=NamespaceUtil
ev=JString
er=MidiDecoder
ez=ModeWhat
dw=PlayerStats
dv=IntUtil
da=BZip2
dd=BZip2State
de=PacketBit
dr=Packet
dc=Isaac
dq=ByteBufferNode
dx=ByteArrayCopier
d=MouseTracking
az=FileOnDisk
ak=BufferedFile
ah=NpcType
aa=LocType
dt=Huffman
ep=Cp1252
et=StringComparator
fp=WorldRegion
ff=PlayerCustomisation
fm=ServerKeyEvents
an=ObjType
bh=Tone
bk=Envelope
bt=Filter
bc=MillisTimer
bn=Timer
bw=ClientStream
bg=FileStream
bu=GameShell
bx=JavaKeyboardProvider
bq=GameCanvas
ba=JavaMouseProvider
bb=JavaMouseWheelProvider
bd=MouseWheelProvider
dk=GZip
dm=PreciseSleep
ek=MidiPcmStream
ag=PcmStream
ay=Sound
fg=ReflectionCheckNode
fh=ReflectionCheck
gy=Namespace
gg=PixFont
cu=Pix2D
fv=DoublyLinkable
cv=Pix3D
bi=VorbisResidue
ad=VorbisSound
ch=NanoTimer
cl=SignLinkCacheFolder
cr=AwtPixMap
cz=PixMap
ce=BufferedPixMap
cb=Texture
ci=TileOverlay
cf=Entity
cx=World3D
ca=Location
cq=AnimFrame
cg=AnimBase
co=Ground
dp=Occlude
fa=LinkList
u=World
x=WorldList
bl=PrivilegedRequest
cw=ModelLit
df=ModelUnlit
do=ArrayUtil
ec=ModeGame
dz=ModeGameProvider
du=MonotonicTime
ea=MidiInstrument
bz=PcmSound
ed=MidiSound
fu=CollisionMap
fj=Protocol
fr=JavConfigParameter
fs=Utf8
dj=WorldTextureProvider
db=TextureProvider
ds=AnimFrameSet
fl=LruCache
fq=DoublyLinkList
fw=PlayerModel
ct=Pix8
cc=Pix32
f=TextUtil
n=PlayerEntity
y=PathingEntity
b=NpcEntity
w=ScriptRunner
be=Wave
fk=IfType
r=ClientScript
k=PublicKeys
j=LoginScreen
as=FloType
am=FluType
ab=IdkType
fb=SoftwareFont
al=SeqType
ae=SpotAnimType
fc=VarProvider
ai=VarBitType
af=VarPlayerType
av=InvType
aj=EnumType
at=AudioChannel
ej=MidiPlayer
cj=SpriteDataProvider
em=HardwarePlatform
ee=Js5LocalRequest
ew=Js5RemoteThread
bm=CacheUtil
br=SignLink
ax=AudioSource
eh=Js5RemoteRequest
ex=MidiNote
eo=MidiNoteStream
en=Song
dn=ByteArrayPool
cn=JagException
by=PcmResampler
bf=VorbisCookbook
bp=SoundBank
bs=AudioThread
ac=JavaAudioChannel
aq=VorbisMapping
t=ClientInvCache
i=SpotAnimEntity
z=GoSubFrame
fo=IntHashTable
gc=WordPack
c=SubInterface
e=PositionedSound
aw=SoundPcmStream
a=LocSpawned
ft=ServerKeyProperties
q=ClanMember
ao=JavaAudioChannel
h=LocEntity
ap=MixerPcmStream
bo=MixerListener
ei=ChatFilterPrivacy
g=FriendListEntry
l=IgnoreListEntry
cy=TileUnderlay
dg=GroundDecor
cd=GroundObject
cs=Wall
dy=Decor
ar=VorbisFloor
cp=VertexNormal
cm=FaceNormal
fx=ByteArrayNode
o=WorldEntry
s=ProjAnimEntity
m=ObjStackEntity
