sign/signlink=sign/signlink
client=client
a=GameShell
b=ViewBox
c=World
d=ClientStream
e=AnimBase
f=AnimFrame
g=Decor
h=TileOverlay
i=GroundDecor
j=GroundObject
k=Metadata
l=Occlude
m=VertexNormal
n=TileUnderlay
o=Location
p=Wall
q=World3D
r=LruCache
s=HashTable
t=Linkable
u=ObjStackEntity
v=Entity
w=PathingEntity
x=NpcEntity
y=PlayerEntity
z=ProjectileEntity
ab=SpotAnimEntity
bb=Tile
cb=DoublyLinkable
db=Model
eb=Pix2D
fb=Pix3D
gb=Pix32
hb=Pix8
ib=PixFont
jb=Packet
kb=LocMerged
lb=LocSpawned
mb=LocEntity
nb=LinkList
ob=DoublyLinkList
pb=PixMap
qb=BZip2
rb=BZip2State
sb=Isaac
tb=Jagfile
ub=JString
vb=WordPack
wb=LocType
xb=NpcType
yb=ObjType
zb=Protocol
ac=CollisionMap
bc=FloType
cc=IdkType
dc=Component
ec=UnkType
fc=SeqType
gc=SpotAnimType
hc=VarpType
ic=WordFilter
