sign/signlink=sign/signlink
client=client
a=GameShell
b=ViewBox
c=World
d=Component
e=ClientStream
f=AnimBase
g=AnimFrame
h=Decor
i=TileOverlay
j=GroundDecor
k=GroundObject
l=Metadata
m=Occlude
n=VertexNormal
o=TileUnderlay
p=Location
q=Wall
r=World3D
s=LruCache
t=HashTable
u=Linkable
v=Tile
w=DoublyLinkable
x=Entity
y=PathingEntity
z=NpcEntity
ab=PlayerEntity
bb=LocEntity
cb=ObjStackEntity
db=ProjectileEntity
eb=Model
fb=SpotAnimEntity
gb=Pix2D
hb=Pix3D
ib=Pix32
jb=Pix8
kb=PixFont
lb=PixFontFull
mb=Packet
nb=OnDemandRequest
ob=LocSpawned
pb=LinkList
qb=DoublyLinkList
rb=PixMap
sb=BZip2
tb=BZip2State
ub=OnDemandProvider
vb=OnDemand
wb=FileStream
xb=Isaac
yb=Jagfile
zb=JString
ac=WordPack
bc=Envelope
cc=Filter
dc=Wave
ec=Tone
fc=LocType
gc=MouseTracking
hc=NpcType
ic=ObjType
jc=Protocol
kc=CollisionMap
lc=FloType
mc=IdkType
nc=UnkType
oc=SeqType
pc=Stats
qc=SpotAnimType
rc=VarbitType
sc=VarpType
tc=WordFilter
