sign/signlink=sign/signlink
client=client
a=GameShell
b=ViewBox
c=World
d=ClientStream
e=InputTracking
f=AnimBase
g=AnimFrame
h=Decor
i=TileOverlay
j=GroundDecor
k=GroundObject
l=Metadata
m=Occlude
n=VertexNormal
o=TileUnderlay
p=Location
q=Wall
r=World3D
s=LruCache
t=HashTable
u=Linkable
v=ObjStackEntity
w=Entity
x=PathingEntity
y=NpcEntity
z=PlayerEntity
ab=ProjectileEntity
bb=SpotAnimEntity
cb=Tile
db=DoublyLinkable
eb=Model
fb=Pix2D
gb=Pix3D
hb=Pix32
ib=Pix8
jb=PixFont
kb=Packet
lb=LocMerged
mb=LocSpawned
nb=LocEntity
ob=LinkList
pb=DoublyLinkList
qb=PixMap
rb=BZip2
sb=BZip2State
tb=Isaac
ub=Jagfile
vb=JString
wb=WordPack
xb=LocType
yb=NpcType
zb=ObjType
ac=Protocol
bc=CollisionMap
cc=FloType
dc=IdkType
ec=Component
fc=UnkType
gc=SeqType
hc=SpotAnimType
ic=VarpType
jc=WordFilter
