sign/signlink=sign/signlink
client=client
a=GameShell
b=ViewBox
c=World
d=Component
e=ClientStream
f=InputTracking
g=AnimBase
h=AnimFrame
i=Decor
j=TileOverlay
k=GroundDecor
l=GroundObj
m=Metadata
n=Occlude
o=VertexNormal
p=TileUnderlay
q=Location
r=Wall
s=World3D
t=LruCache
u=HashTable
v=Linkable
w=Tile
x=DoublyLinkable
y=Entity
z=PathingEntity
ab=NpcEntity
bb=PlayerEntity
cb=LocEntity
db=ObjStackEntity
eb=ProjectileEntity
fb=Model
gb=SpotAnimEntity
hb=Pix2D
ib=Pix3D
jb=Pix32
kb=Pix8
lb=PixFont
mb=Packet
nb=OnDemandRequest
ob=LocSpawned
pb=LinkList
qb=DoublyLinkList
rb=PixMap
sb=BZip2
tb=BZip2State
ub=OnDemandProvider
vb=OnDemand
wb=FileStream
xb=Isaac
yb=Jagfile
zb=JString
ac=WordPack
bc=Envelope
cc=Wave
dc=Tone
ec=LocType
fc=NpcType
gc=ObjType
hc=Protocol
ic=CollisionMap
jc=FloType
kc=IdkType
lc=UnkType
mc=SeqType
nc=SpotAnimType
oc=VarpType
pc=WordFilter
